Amblysomus_hottentotus_longiceps	Afrotheria
Chrysochloris_asiatica	Afrotheria
Hydrodamalis_gigas	Afrotheria
Loxodonta_africana	Afrotheria
Elephantulus_edwardii	Afrotheria
Orycteropus_afer	Afrotheria
Microgale_talazaci	Afrotheria
Procavia_capensis	Afrotheria
Echinops_telfairi	Afrotheria
Trichechus_manatus_latirostris	Afrotheria
Hippopotamus_amphibius	Boreoeutheria
Odobenus_rosmarus_divergens	Boreoeutheria
Pteropus_vampyrus	Boreoeutheria
Galeopterus_variegatus	Boreoeutheria
Condylura_cristata	Boreoeutheria
Rattus_norvegicus	Boreoeutheria
Ceratotherium_simum	Boreoeutheria
Manis_javanica	Boreoeutheria
Pan_troglodytes	Boreoeutheria
Tupaia_tana	Boreoeutheria
Chaetophractus_vellerosus	Xenarthra
Tolypeutes_matacus	Xenarthra
Dasypus_novemcinctus	Xenarthra
Bradypus_variegatus	Xenarthra
Choloepus_didactylus	Xenarthra
Megalonyx_jeffersonii	Xenarthra
Megatherium_americanum	Xenarthra
Mylodon_darwinii	Xenarthra
Myrmecophaga_tridactyla	Xenarthra
Tamandua_tetradactyla	Xenarthra
Sarcophilus_harrisii	Metatheria
Didelphis_virginiana	Metatheria
Wallabia_bicolor	Metatheria
Gymnobelideus_leadbeateri	Metatheria
Phalanger_gymnotis	Metatheria
Phascolarctos_cinereus	Metatheria
Potorous_gilbertii	Metatheria
Pseudochirops_corinnae	Metatheria
Thylacinus_cynocephalus	Metatheria
Vombatus_ursinus	Metatheria
